00000000000000000000
00000000000000000000
00000000000000000000
00000000000000000000
00000000000000000000
000001111111110000000
000001222424210000000
00000122222211000000
00000122222221000000
00000123220321000000
00000122213121000000
00000124512221000000
00000111111111000000
00000000000000000000
00000000000000000000
00000000000000000000
00000000000000000000
00000000000000000000
00000000000000000000
00000000000000000000